10 40
1 38
2 2 2 2 2 2 2 2 2 2
2 2 1 1 1 1 1 2 2 2
2 2 1 1 1 1 1 2 2 2
2 2 1 1 1 1 1 2 2 2
2 2 1 1 1 1 1 2 2 2
2 2 1 1 1 1 1 2 2 2
2 2 2 2 1 2 2 2 2 2
2 2 2 2 1 2 2 2 2 2
2 2 2 2 1 2 2 2 2 2
2 2 2 2 1 1 1 2 2 2
2 2 2 2 2 2 1 2 2 2
2 2 2 2 1 1 1 2 2 2
2 2 2 2 1 2 2 2 2 2
2 2 2 1 1 1 2 2 2 2
2 2 2 1 1 1 2 2 2 2
2 2 2 1 1 1 2 2 2 2
2 2 2 2 1 2 2 2 2 2
2 2 2 2 1 2 2 2 2 2
2 2 2 2 1 1 1 1 1 2
2 2 2 2 2 2 2 2 1 2
2 2 2 2 2 2 2 2 1 2
2 2 2 2 2 2 2 2 1 2
2 2 2 2 2 2 2 2 1 2
2 2 2 1 1 1 2 2 1 2
2 2 2 1 1 1 2 2 1 2
2 2 2 1 1 1 2 2 1 2
2 2 2 2 1 2 2 2 1 2
2 2 2 2 1 2 2 2 1 2
2 2 2 2 1 2 2 2 1 2
2 2 2 2 1 1 1 1 1 2
2 2 2 2 2 2 1 2 2 2
2 2 2 2 1 1 1 2 2 2
2 2 2 2 1 2 2 2 2 2
2 2 2 1 1 1 2 2 2 2
2 2 2 1 1 1 2 2 2 2
2 2 2 1 1 1 2 2 2 2
2 2 2 2 1 2 2 2 2 2
2 2 2 2 1 2 2 2 2 2
2 1 1 1 1 2 2 2 2 2
2 2 2 2 2 2 2 2 2 2